33
.#...............................
.#...............................
.#...............................
.#...............................
.#...............................
.#...............................
.#...............................
.#...............................
.#...............................
.#...............................
.#...............................
.#...............................
.#...............................
.#...............................
.#...............................
.#...............................
.#...............................
.#...............................
.#...............................
.#...............................
.#...............................
.#...............................
.#...............................
.#...............................
.#...............................
.#...............................
.#...............................
.#...............................
.#...............................
.#...............................
.#............................#..
.############################.#..
..............................#..
