10
.#...#....
.#.#.#..#.
...#.#..#.
####.#..#.
.....#..#.
.#####..#.
.#....#.#.
.######.#.
........#.
#########.
